Transaction Date,Transaction Type,Sort Code,Account Number,Transaction Description,Debit Amount,Credit Amount,Balance
04/10/2016,TFR,'30-93-29,22770,I S BOOKS LTD 309329 00089719 ,92,,0
04/10/2016,FPI,'30-93-29,22770,COX R COX ROSIE 5148522064323014SO 404760     30 04OCT16 02:13 ,,10,92
04/10/2016,FPI,'30-93-29,22770,GRANT N GRANT N 3234501554323015SO 404780     30 04OCT16 02:09 ,,15,82
04/10/2016,FPI,'30-93-29,22770,JOHNSTON S NO REF RP4652784055626500 204846     30 04OCT16 01:46 ,,15,67
04/10/2016,SO,'30-93-29,22770,ANDERSON R WB4 F ANDERSON ,,10,52
04/10/2016,FPI,'30-93-29,22770,FRANKLIN SHIRLEY FRANKLIN SHIRLEY FP16277O43060490 070246     30 04OCT16 00:33 ,,15,42
